    ######
  ###    ###
  #   #$   ###
  #   $   $$ #
  # $$ #$    #
  ##   $   $ #
###### #$#####
#..@ #$  #
#.#..  $##
#....$# #
#....   #
#########
