#########
#   ##  #
# # $ $ #
#  *.#  #
## #.@.##
##$###*###
#        #
#   ## # #
######   #
     #####
