#########
#       #
#  $ $ $#
## #$## #
 # .. ..##
 ##.. .. #
  # ##$# ##
  #$ $ $  #
  #      @#
  #########
