######===#####
#    ###=#  .#
#  $ $ #=#...#
# #  $ ###  .#
#  $$$   $ @.#
###  $  $#  .#
  #  $#$ #...#
  ##     #  .#
   ###########
