#####
#@  #
# $$#=###
# $ #=#.#
### ###.#
 ##    .#
 #   #  #
 #   ####
 #####
