#####======####
#@  ########  #
## $       $  #
 # # #  ####  #
 #  $   ####$##
 #$ ## # $ $ #
## $  $#     #
#   #      # #
#   #####$####
#####   #   #
    #...  $ #
    #....#  #
    #....####
    ######
