    ####
#####  #
#  $ $ #=#######
#   $  #=#*.*.*#
## $ $ ###.*.*.#
 #$ $  #  *.*.*#
 #@$ $    .*.*##
 #$ $  #  *.*.*#
## $ $ ###.*.*.#
#   $  #=#*.*.*#
#  $ $ #=#######
#####  #
    ####
