############
#... #     #
#..  # ##  #
#..     #  #
#..  # $## #
#... #$ $  #
######  $$ #
 ##  $ $$  #
 #@ $$$  # #
 ## $ ##   #
 #         #
 ###########
