########
#......#
#  $ # ##
# $ # $ #
##$ $ $ #
 #  @   #
 ########
