 #########
 #   ##  ####
 # $        #
 ##$### ##  #
 #  ## * # ##
 # $...... #
## ### . # #
#     $###$#
#   #    $@#
#####$# ####
    #   #
    #####
