 ####==#####
##  #==#   #
# $ ####$  #
#  $.... $ #
##    # @ ##
 ##########
