      #########
      #       #
      # # # # #
      #  $ $# #
#######   $   #
#..#  ## $ $# #
#..   ## $ $  #
#..#  ## ######
#..# # $ $ #
#..     $  #
#  ### @ ###
####=#####
